1111111110111
00010000000C1
1000011111000
1P0011E000001
1111110111111
