111111111111111111111111
1E000C0000000000000C00C1
1000000000P0000000000001
111111111111111111111111
