111111111111111111111111
1E0C0C0C0C0C0C0C0C0C01P1
10C0C0C0C0C0C0C0C0C0C001
111111111111111111111111
